0000000000000000000000000000000000000000
0            f   i h i   f             0
0            f   i i i   f             0
0            f   y   y   f             0
0            f           f             0
0a b i h i b c f a j c f a b c f a b c 0
0d e i i i e f f i i i f d e f f d e f 0
0                                      0
0                                      0
0                                      0
0                                      0
0                                      0
0                                      0
0                                      0
0                                      0
0                                      0
0                                      0
0                                      0
0                                      0
0                                      0
0                                      0
0                                      0
0                                      0
0                                      0
0                                      0
0                                      0
0                                      0
0                                      0
0                                      0