0000000000000000000000000000000000000000
0                 x                    0
0                                      0
0                                      0
0                                      0
0            d e c   a h b             0
0            a j f   e f c             0
0                                      0
0                                      0
0i  i  i  i  i  i  i  i  i  i  i  i  i 0
0                                      0
0                                      0
0                                      0
0                                      0
0                                      0
0                                      0
0                                      0
0                                      0
0                                      0
0                                      0
0                                      0
0                                      0
0                                      0
0                                      0
0                                      0
0                                      0
0                                      0
0                                      0
0                                      0